OOOOOOOOOOOOOOOOOOOOOOOOOOOOOOOOOOOOOOOOOO
OT T   T         TTT             TTTTTTTTO
O                         P       TTTTTTTO
OTT       TT   TTTT                TTTTTTO
OTT           TTTTTTT     T          TTTTO
O       V     TTTTTTT         TT       TTO
O       TTT    TTTTT         TTTTTTT     O
O      TT                  TTTTTTTTTT    O
WWWW          WWWEWWWW     TTTTTTTTg     O
O  WW     WWWWW      WWWWW     TTTT      O
O   W  WWWW              WWWWW           O
O   WWWW                     WWWW  WWWWWWW
O        T    BBBDBBB           WWWW     O
O   T   TT   TB     BT T          T   T  O
O        T TTTB     BTTTT            T   O
O  T       TTTB     BBBBBB      TT   T   O
O      T   TTTB          B              TO
O      T   TTTB  V     g BT           TTTO
O    V     TTTB          BT           TTTO
O      T      BBBBBBBBBBBBT   TT     TTTTO
O                   TT         T     TTTTO
O  T            T   TT        TT    TTTTTO
O         WW    TT    T             TTTTTO
O   T    WWWW           T    T       TTTTO
O    TT  WWWWW     T                  TTTO
O    T    WWWW              V V        TTO
O              TT     TT              TTTO
WWW          T         TT    T        TTTO
O W      V  TT                         TTO
O WW            WWWWWW           TT     TO
OB WW           W    WWWWW        T      O
Og  E          WW        WWWWW           O
OBB WWW   WWWWWW   TTT       W      T    O
O     WWWWW       TTTTTTTT   W           O
OOOOOOOOOOOOOOOOOOOOOOOOOOOOOWOOOOOOOOOOOO