OOOOOOOOOOOOOOOOOOOOOOOOOOOOOOOOOOOOOOOOOO
OQQQQQQQQQQQQQQQQQQQQQQQQQQQQQQQQQQQQQQQQO
OQQQQQQQQQQQQQQQQQQQQQQQQQQQQQQQQQQQQQQQQO
OQQQQQQQQQQQQQQQQQQQQQQQQQQQQQQQQQQQQQQQQO
WWWWWWWWWWWWWWWWWWWWWWWWWWQQQQQQQQQQQQQQQO
WWWWWWWWWWWWWWWWWWWWWWWWWWWWWWQQQQQQQQQQQO
WWWWWWWWWWWWWWWWWWWWWWWWWWWWWWWWWQQQQQQQQO
OSSSSSSSSSSSSSSSSSSSSSWWWWWWWWWWWWWQQQQQQO
OSSSSSSSSSSSSSSSSSSSSSSSSSWWWWWWWWWQQQQQQO
OSSSSSSSSSSSSSSSSSSSSSSSSSSSSWWWWWWWQQQQQO
O                  TTTSSSSSSSSSWWWWWQQQQQO
O      TT         TTTTT   SSSSSWWWWWQQQQQO
O      TT         TTPTT     SSSWWWWWWQQQQO
O     TTTT                  SSSWWWWWWQQQQO
OT     TTTT                  SSSWWWWWQQQQO
OT               TT          SSSWWWWWQQQQO
OTT            TTTTT        gSSSWWWWWQQQQO
OTT            TTTTT     V   SSSWWWWWQQQQO
OTT             TT           SSSWWWWWQQQQO
OTT       TTTTT              SSSWWWWWQQQQO
OTTT       TTT     WWWW      SSSWWWWWQQQQO
OTTT              WW  WWEWW   SSSWWWWQQQQO
OTTT             WW       WWWWWWWWWWWQQQQO
OTTT             W TT         SSSWWWWQQQQO
OTT              W  TT        SSSWWWWQQQQO
OT               W  TTT       SSSWWWWQQQQO
O            TTT W  TT         SSSWWWQQQQO
OT           WWWWW             SSSWWWQQQQO
O            E                 SSSWWWQQQQO
O TTTTT      W                 SSSWWWQQQQO
O  TTTT  WWWWW         V       SSSWWWQQQQO
O        W            T        SSSWWWQQQQO
O        W        TTTTTTT      SSSWWWQQQQO
OT T  TT W       TTTTTTTTTTTT  SSSWWWQQQQO
OOOOOOOOOWOOOOOOOOOOOOOOOOOOOOOOOOWWWOOOOO