OWWOOOOOOWOOOOOOOOOOOOOOOOOOOOOOOOOOOOOOOO
WWW     TWfFFFFFFFFFFFFFFFFFFFFFFFFFFFFFFO
WW      FWfg TT    T             T      FO
O   t   TWfT  T TT T TTTTTTFTTTT   T TTTFO
O       WWf f T  T   T     T   TTFTT    FO
OT      E   f TT FTTTT TT TT TTTT TT  T FO
OF    TWWT    FT       F  T     T     T FO
OF    TWTTTTT    TFTT    TF TTT TFTTTTTgFO
OFTT FTWT      TTT  T TT TT T FTTTT   TTFO
OF    TWFTT  T T T TT  T  T   T   T T   FO
OF    TWT             TFT T  TTT TT FTT FO
OFTTTTTWTTTFTT TT  TT T          T    T FO
OFTg   WTg  T   F TT  TTTTF TTTT T  T T FO
OFTTTTTWFTT T TTT FT    T   T FT    T T FO
OFTTTTTWT   T     T   T   T T TTT TTFTT FO
OF T TWWT T F   T T T TT TTgT      Tg   TO
OF T TWTT TTTT  T T   WW TFTT TT  TTTTTTTO
OF    E   T  TT TTFTT WW       T   T    WW
OF    WT TTF    T T T    FT TFTT T      WO
OF    WT   T  T   T   TFT   T TTTTTT   PEO
OF  TWWT T TT TTT T T T   T    F        WO
OF  TWTF TgT   TF   T    TFT   T T T    WW
OFT FWT  TTTF   TT TFT T     T   T FTTTTTO
OF  TWTT    TTT        FT TFTT TFTTTgT  TO
OF  TWWFTTT     TTTFT TT   T    T T  T  FO
OF   TWWWWFT TTTFg T   TT F  TT   T  FT FO
OF   TTTTWT     TT   T  F   FT  TTT TT  FO
OF     tTWTTT T  T   T  TT  T  TT   T  TFO
OF      TWT   T  FT  TT  TT T TTFT  T f FO
OF V    TWTT TFT T  T TT        TT      FO
OFT  v  TWWT  T    TT gT TTT TT  T  T T FO
OFTT    TTWT TT TT  T T    T T  TTT TTTTFO
OFTTTT  TgWT  T       TT TTTTTT         FO
OFFFFFFFFFWFFFFFFFFFFFFFFFFFFFFFFFFFFFFFFO
OOOOOOOOOOWOOOOOOOOOOOOOOOOOOOOOOOOOOOOOOO