OOOOWOOOOOOOOOOOOOOOOOOOOOOOOOOOOOOOOOOOOO
Of  W      f      f       fffff    f    fO
OL  W          f      f     f            O
Ogf WWW            ff  f    t       f    O
Of    WWWWWWW       f     f    f   f     O
O  WWWW     WWWW          f   f    ff    O
O WW     ff    WWWWWW  f   f             O
OWW          f      WWW     v    f       O
O   f                 WWW            WWWWW
Of       t     v     ff W ff   f WWWWW   O
Of                      WW     WWW       O
Of   f  v   f     f      WWWEWWW     f   O
O  f                                     O
O    f  f    fBBBBBBBBBBBB  t  BBBBBBBBBBO
O     f  BBBBBB     fff            f  BABO
OBBDBBBBBB    ff                  f   D BO
OBg B    f         ff      v   f  f   BBBO
OBBBB       ft      ff                 WWW
O       f   fff   v  f   ff      WWWWWWW O
O                              WWW       O
O   f  WWWWWWW  fff         WWWW  f f   fO
O  WWWWW     W  ff  f       W        f  fO
WWWWf    ff  WW     f       E   ff       O
O     f       W          WWWW         t  O
O   v   ff    WWWEWWW   WW         v    fO
O             f     WWWWW     f      f   O
OT   T  ff       f      W              f O
OT      WWTf    TTTf    WW       f      fO
OT TT  WWWW  TT          W           T TTO
O      WWWW  T    v   TT WWWWWWWWWW     TO
OT      WW     T                  WWWW TTO
OT                T TTTTTT     TT    WWWWW
O  P T    T    TTTTTTTTT      TTTTT      O
O    TT   TT  TTTTTTTTTg     TTTTTTT    TO
OOOOOOOOOOOOOOOOOOOOOOOOOOOOOOOOOOOOOOOOOO