OOOOOOOOOOOOOOOOOOOOOOOOOOOOOWOOOOOOOOOOOO
O         T                  W         L O
O T       TTT                WWWW        O
O                               WW    T  O
O   WWWWWWWW                     WW  T   O
O T WBBBBBBW  TTT       TT    T   W      O
OTT WBgLGgBW  T     T   TT        W    T O
OTT WBGLGLBW        TT           WW T    O
O T WBGGGGBW    V V  T           W    P  O
O   WBLGLgBW T            V   T WW   T   O
O   WBG GLBW      T T           W    T   O
O   WBBBDBBW     TTTTT    V  T  W        O
O   WWWWWWWW     TTTTTT         W     TT O
O              WWTTTTT     T    W  T   T O
O    T     T  WWWWTTT     TTT   W TT     O
O  TTTT     TTWWWW         T    W        O
O   T        TTWW              WW    TT  O
O             T           WWWWWW         O
TT     TTT           T    W  T WWW  WEW  O
TTT     TT           TTT WW T    WW W WW O
TT      T  V V V      TTWW  T     WWW  WWW
O    T            TT   WW      T         O
O   TTT    V V V  TTT  E      TT    TT   O
O     T          TTTT WW      T     T    O
O            T     T WW                  O
O   TT      TTT     WW   V V V           O
O  TTTT      TTT    W T TT    GG         O
O  TTTTT      TT    W TTT  V GLLG    TT  O
O   TTTT      WWW   W TTTV   GLLLG    T  O
WW    T      WW WW WW  T      GGG        O
OWW          W   WWW      T              O
O W       W  W           TTT   TTT       O
O WW     WWW W       TTT  T              O
O  W     WTWWW      TTTT  T              O
OOOWOOOOOWOOOOOOOOOOOTTOOOOOOOOOOOOOOOOOOO