OOOOOOOOOOOOOOOOOOOOOOOOOOOOOOOOOOOOOOOOOO
O     W                          SSSWWWQQO
O    WW      T T       V V       SSSWWWQQO
O    W      TTTTT   V        T   SSSWWWQQO
O    W      TTTTT        V  TT    SSSWWWQO
O T  WW WWW  TTT                 SSSSWWWQO
O TT  WWW WW  T BBBBB            SSSSWWWQO
O    GGG   WWW BB g BB           SSSWWWQQO
O   GLLLG V  WBB   TTBTT    V   SSSWWWQQQO
O    GLG    WWB   TTTBTTTTT     SSSWWWQQQO
O     G  WWEW B   TTTBTTTT      SSSWWWQQQO
O       WWBDB B    TBB          SSSSWWWQQO
O      WW B BBB V   B       T    SSSSWWWQO
OP    WWBBB         B      TTT   SSSSWWWQO
O     W B     BBB   D  V         SSSWWWQQO
O    WWBB   V BgD   B     T     SSSWWWQQQO
O    WBB  V V BBB  BB  TTTTT    SSSWWWQQQO
O   WWB V         VB     T      SSSSWWWQQO
O   WVB V   T   V  B  V         SSSSWWWQQO
O  WW BDBB        BB         V   SSSWWWQQO
OWWWWWWEWBB   BBBBB       T      SSSWWWQQO
O       WWBBBBBWWWWW      T      SSSSWWWQO
O        WBBWWWWT  WW          SSSSSSWWWQO
O   V    WWWWT  T   WW         SSSSSWWWQQO
O      V    TTTTTTT  WWW   T   SSSSSWWWQQO
O            TTTTTTT   W        SSSSSWWWQO
O        T             WW   V   SSSSSWWWQO
O    TTTTT  V           W       SSSSWWWQQO
O  TTTTTTTT   V     V   WW     SSSSSWWWQQO
O   TTTTTT               W     SSSSWWWQQQO
O    TTgTT       V       WW     SSSWWWQQQO
O      V      T           W     SSSWWWQQQO
O             TTT         WWWW  SSSWWWQQQO
O              T             WWWWWWWWQQQQO
OOOOOOOOOOOOOOOOOOOOOOOOOOOOOOOOOOOOOOOOOO