OOOOOOOOOOOOOOOOOOOOOOOOOOOOOOOOOOOOOOOOOO
O                                        O
O         TT                             O
O                                        O
O                                        O
O                  TT              T     O
O                                        O
O                   T                    O
O                   T                    O
O                              T         O
O                                        O
O                                        O
O        TT                              O
O                                        O
O                 0           TTT        O
O                              T         O
O                                        O
O          T                             O
O                                        O
O                                        O
O                                        O
O                   TT                   O
O        T                               O
O                                        O
O                TT                      O
O                                        O
O                                        O
O                                        O
O                 T                      O
O                                TT      O
O                        T               O
O                       TTT              O
O                                        O
O                                        O
OOOOOOOOOOOOOOOOOOOOOOOOOOOOOOOOOOOOOOOOOO